s.#########
#.#.#...#.#
#.#.###.#.#
#.#.....#.#
#.#.#####.#
#.........#
#.###.#####
#...#...#.#
###.###.#.#
#...#.....#
#########.t
