s.###############################################
#...#...#.#.#.#.#.#...#...#.....#.....#.........#
#.###.###.#.#.#.#.#.###.###.#######.#.###.#######
#...#...#.#.....#.........#.........#.#.#...#...#
#.#####.#.#####.#.###.#.#.#.###.###.#.#.#.#####.#
#.........#.#...#.#...#.#.#...#.#...#.#.....#...#
#.#####.#.#.#.#.###.#####.###.#.###.#.###.###.###
#...#...#.#...#.#.....#...#...#.#...#.#.....#.#.#
#########.#.#####.#.#.#.#####.###.###.###.###.#.#
#...#.....#.....#.#.#.#.........#...#.#.........#
#.#.#.#.#.###.#.#####.###########.###.###.#######
#.#...#.#.#...#...#.#.#.......#...#.#...#.#...#.#
#.#.#####.#####.#.#.#.#.#.#.#.#.#.#.#.#.#.#.###.#
#.#...#...#.....#.....#.#.#.#...#...#.#.........#
#########.#####################.#################
#...#.#...#.......................#...#.#...#.#.#
###.#.#.#.#.#######################.###.#.###.#.#
#.....#.#.#...#.......#.#.#.#.#.#.#...#.#...#.#.#
###.###.#.###.#.#.#.#.#.#.#.#.#.#.#.#.#.#.###.#.#
#.......#.#.....#.#.#.............#.#...#.......#
#.#########.#######################.###.#.#####.#
#.........#.....#.#.....#.......#.#...#.......#.#
#.#.#####.###.###.#.###.#.###.#.#.#########.#####
#.#...#...#.........#.....#.#.#...#.........#.#.#
#####.#######.#####.#.###.#.###.###.#.#######.#.#
#.........#.....#...#...#...#...#.#.#...#...#...#
#.#########.#.###.#########.#.###.#.###.#.###.#.#
#...#.....#.#...#.......#...#.....#.#.........#.#
#.#.#.#.#.#.#.###.#.###.###.#.#####.#.###.###.#.#
#.#...#.#.#.#...#.#...#.#...#.....#.#...#...#.#.#
#.#.###.#######.#########.###################.###
#.#.#.#.#.#.....#...#.#.#.#.#.#...#.#...#...#...#
#.#.#.#.#.#####.###.#.#.#.#.#.###.#.#.###.#####.#
#.#.#.....#.#.#.#...#...#.#.#.#...#.............#
#########.#.#.#.###.#.###.#.#.###.#.#.###.#######
#.....#.#.#.....#...#.............#.#...#...#...#
#.#.#.#.#.#.#######.#####.###.#########.#.#.#.#.#
#.#.#.....#.....#.#.......#.......#.....#.#...#.#
###.###.###.#.#.#.#.#####.#####.#.###########.###
#...#.....#.#.#.#...#.....#.#.#.#.#.............#
#.#.###.#######.###.###.###.#.#.#.#######.#######
#.#.#.....#.....#...#.....#.....#.#.#...........#
###.###################.###########.###.#.###.#.#
#.........#...#.#.#.....#.....#...#.....#...#.#.#
#######.###.###.#.#.#.#.#####.#.#.###.###.###.#.#
#...#...#.....#.....#.#...#.#...#.......#...#.#.#
#.#.###.#.###.###.#####.#.#.#.#.#.#####.#########
#.#.......#.......#.....#.....#.#.#.............#
###############################################.t
