s.#################################################
#...#.#...#.....#.#.......#.....#.#.....#.#.......#
#.#.#.#.#.#.###.#.#.###.###.#.###.###.#.#.###.#####
#.#.#.#.#...#...#...#.#...#.#...#.....#.#.#.......#
###.#.###.###.###.#.#.###.#.###.#.#.###.#.#.#######
#...#.......#...#.#...#.....#.....#...#...#...#...#
#.###.#.#################.#################.#####.#
#.#...#.#.......#...#.....#.......#.#.#...#.#.....#
#.#.#.#.#.#.#.#.###.###.#.#####.###.#.#.###.#.#.#.#
#...#.#...#.#.#.#...#...#.....#.....#.....#...#.#.#
###.#########.#####.#.#.#.###.#.###.#####.###.#####
#...#...........#...#.#.#.#.#.#...#.......#.......#
#############.###.#######.#.#.#.###.###.###.#######
#.....#.#...#.#.#...#.....#.......#.#.....#.....#.#
#.#.###.#.#.#.#.###.#######.###############.#.###.#
#.#.......#.....#...#.#.#.......#.#...#...#.#.#.#.#
#############.###.###.#.#.###.#.#.#.#####.#.#.#.#.#
#.....#...#...#.#...#.....#...#.#.#.......#.#.....#
#.###.#.#.#.###.###.#.#.#.###.#.#.###.#######.#####
#.#...#.#.#...#.#...#.#.#.#...#...#.......#.......#
#.#.###.#.###.#.#.###.###.#######.#.#.###.#.#######
#.#.....#.......#.....#.....#...#.#.#...#.#.......#
#.#################.#.#.#.#####.#.#.#.#########.###
#...#.........#.....#.#.#.......#.#.#.....#.......#
#.###.#####.#.#.#.###########.#####.#.###.#.###.#.#
#...#.#.#...#...#...#...#.#...#...#.#.#...#...#.#.#
###.#.#.#.###.#####.#.###.###.#.#####.#######.#####
#.#...#.....#...#...#...........#.#...#...#.#.#...#
#.#.#.#.###.###.#.#####.#.###.#.#.###.#.###.#.#.#.#
#...#.#.#...#...#...#...#.#...#...#...#...#.....#.#
###########.#######.#.#####.#.###.#.#####.#.#.###.#
#.#.#.#...#...#.#...#.....#.#.#...........#.#.#...#
#.#.#.###.###.#.#############.###################.#
#.#.#.#.......#.#.#.#.......#.......#.....#.......#
#.#.#.#.###.###.#.#.#.###.#.###.###.#.#####.#######
#.........#...#.#.....#...#.....#.........#.#...#.#
#.#####.###.###.#####.#####.#####.#####.###.#.#.#.#
#.#.......#...#.#.....#.#.#.#.......#.#...#.#.#...#
#.#.###.#####.#.#.###.#.#.#.#####.#.#.#.#.#.###.#.#
#.#...#...#.....#...#.#.....#...#.#.#...#.......#.#
#.#.###.###.###.###.#####.###.#.#.#.###.#####.#####
#.#...#...#...#.#.....#.....#.#...#.#.....#.#.#.#.#
#.#########################################.#.#.#.#
#.....#.....#.#.#...#...#.#.........#.....#.#.....#
#.#.###.#.#.#.#.#.#.###.#.#.#.#.#####.#####.###.#.#
#.#.....#.#.#.#...#.........#.#.#.#.#.....#.....#.#
#.#.#.#####.#.#.###.#.#######.#.#.#.#.#######.#####
#.#.#.#.....#...#...#.....#.#.#.........#.#.......#
#.###.#####.#.#.#######.#.#.#.###.###.#.#.###.#####
#.#...#.......#.....#...#...#.#.....#.#...#.......#
#################################################.t
