s.###################################################################################################
#.......#.#.#...#.....#.....#...#.....#.....#.#...#...#.#.#...#.#.....#.#.#.....#.....#.#...#.#.....#
#######.#.#.###.#####.#.#.#.#.###.#.#.#.###.#.#.#####.#.#.###.#.#.#.###.#.###.#.#.#.###.###.#.###.###
#...#.......#...#...#.#.#.#.#...#.#.#.#.#.#.......#...#...#.......#.#.......#.#...#.#.......#...#...#
#.#.#.#####.###.###.#.#####.#.#####.#####.###.#######.#.#####.#.#######.#.#####.###########.###.#.###
#.#.#.#.....#.........#...#...#.#...#.#.#.#.#.#.#.#.#.....#...#...#...#.#.#.#...........#.#...#.#.#.#
#.#.#####.#.###.#.#.#.#.#####.#.###.#.#.#.#.#.#.#.#.#.###.#####.#.#.###.###.###.#########.###.#.#.#.#
#.#...#...#.#.#.#.#.#...........#...#.#.#...#.........#.#.#.....#.#.#.....#.#.#.#.#...#...#...#...#.#
#####.#####.#.###.#.###.###.###.###.#.#.###.###.#.###.#.#######.###.###.#.#.#.#.#.#.#####.###.###.#.#
#...#.............#.#.....#.#...........#...#.#.#.#.....#.#.#.#.#...#.#.#...#.......#.#...#.#.......#
#.###.#####.#.#.#.#####.###.###.#.###.#####.#.#########.#.#.#.#.###.#.###.###.#######.###.#.###.#####
#.....#.....#.#.#.#.#.....#...#.#.#.#.#.......#.#.....#.#...#.....#.#...#.#.....#.#.#...............#
#.#########.#####.#.#####.###.#.#.#.#.###.###.#.#####.#.#.#####.###.###.#.###.###.#.#########.#######
#.#.........#.........#...#...#.#.#...#...#...................#.#.....#.#...#...#.....#...#.#.......#
#####.#.###.###.#####################.#########.#.#######.#####.###.###.#.###.###.#######.#.#.###.###
#.....#.#.#.#.#.#...#.......#.#.....#.#.#...#...#.#...#...#.#.#.....#.#.#.#.#.........#.#.#.#...#.#.#
#########.###.#####.#######.#.###.###.#.#.###########.###.#.#.#.#.#.#.#.#.#.#.#.#.###.#.#.#.#.#.###.#
#...#.#.............#...#.#...#.#...............#.#.#...#.#.#.#.#.#.......#.#.#.#...#...#...#.#.....#
###.#.#.#######.###.###.#.###.#.#.###.###.#####.#.#.#.###.#.#.#######.#.###.#.#############.#.#######
#...#...#.#...#.#.........#.......#.#...#.#.................#.....#.#.#.#.#.............#.......#...#
###.#.###.###.#######.#.###.#.###.#.#####.#########.###.###.#####.#.###.#.#.#.#####.#####.###.#####.#
#.....#.#.....#.....#.#...#.#.#...#.#.......#.#.#.#.#.....#.....#...#.....#.#.....#...#.....#.#.....#
#.#.###.#####.###.#.###.#.#.###.###.#.#######.#.#.###.#######.###.###.###.#.###.#.#.###.###.#####.###
#.#...#.#.........#.....#.....#.#...#.#.......#.#.#...#.....#.#.#.#.....#.#...#.#.#.#.#...#.#...#...#
#.#.###.###.###.###.#.#.#.###.#####.#########.#.#.#######.###.#.#.###.#####.#########.#.#######.#.#.#
#.#.#.....#.#.....#.#.#.#.#...#.#.....#...#.....#.#.#...#.#.........#...#.....#.#.....#.....#.....#.#
#.#.###.###########.###.#.#####.#####.#.###.###.#.#.#.###.###.#####.###.###.###.#####.#.#######.#####
#.#.#.......#.#...#.#.#.#.#.#.#.#.........#.#.................#.......#.#...#.....#.#.....#.#.#...#.#
#########.###.#.#.#.#.###.#.#.#.#.#.#.###.###############.###.#####.###.###.###.#.#.#.#####.#.#.###.#
#.#.#...#.......#...#.#...#.#...#.#.#...#...#.....#.#.#...#...#...#.........#...#.#...#...#.#.#.#...#
#.#.#.#######.###.###.#####.#.#####.#####.#.###.###.#.#######.###.#####.#.#####.###.###.#.#.#.#.#.###
#.....#.......#.....#.#.#.....#...#...#...#...#...#...#.#...#.#.......#.#.......#.#...#.#.#.#.#.....#
#####.#####.###.#.###.#.###.#.###.###########.#.#####.#.#.#.#####.###.###.###.#.#.#.###.###.#.#.#####
#.#.#.....#.#.#.#.#.#...#.#.#.#...#.#.#.......#.......#...#.#...#.#.........#.#.#.#.#...#.#.........#
#.#.#.#.#####.#####.#.#.#.###.#.#.#.#.#.#####.#######.#.#.#####.#######.#########.#.###.#.#.#########
#.....#.#.#...#...#.#.#.........#.......#.#.#.....#.#.#.#.#...#.#.#...#...#.#.#.....................#
#.#####.#.###.#.###.###########.#.#.#####.#.#.#####.#.###.#.###.#.###.###.#.#.#.#.#.###.#.#.###.#.###
#.#.#...............#.#...#.#.#.#.#.#.........#.........#.......................#.#...#.#.#...#.#.#.#
#.#.#.###.#.#######.#.#.###.#.###############.#####.###.#.###.#.#.#####.###.###.#########.###.#.###.#
#.#...#...#.#...............#.#.........#.....#.......#.#...#.#.#.#.......#...#.....#.....#.#.#.....#
#.#.#.###.#.###.#.#####.###.#.###.#.###.#.###.#####.###.#####.#.#.#.###.#.#.#.#.#######.#.#.###.###.#
#.#.#.#...#...#.#...#...#.......#.#.#.#.#...#...#.#.#.......#.#.#.#.#.#.#.#.#.#.......#.#.....#...#.#
#########.#######.###.#.#.#.#.#.#.###.#######.###.#####.#.#.###.###.#.#.#.###########.###.#.#####.###
#.........#...#...#.#.#.#.#.#.#.......#.#.#.#...#...#.#.#.#.......#...#.#...........#...#.#...#.....#
#######.#.#.#####.#.#.#######.###.#.###.#.#.#.#####.#.###.#.#.#####.#####.###.#.#####.#.###.#.###.###
#.......#.#.#.....#...#.......#.#.#.....#...#...........#.#.#...#.....#.....#.#.....#.#...#.#.#.....#
#######.###.#####.#############.###.#######.#.#.###.###.#.###.#.###.#.###.#.#####.###.#.#.#######.###
#.......#...#.#.#.#.#...#.#.#.#...#.......#...#...#.#.....#...#.#...#.#...#.....#.#.#.#.#.....#.....#
#.#.#######.#.#.###.###.#.#.#.###.#######.#.###.#.#.#.###.#####.#.#.#.#####.#.#####.#####.###.#######
#.#...#.....#.#.#...#...#.....#.#.#...#.....#.#.#.#.#.#.....#...#.#.#.#.....#.#.......#.#...#.......#
#.#####.#.#.#.#.#.#####.#####.#.#.#.###.#.#.#.###########.###.###.###########.#.#######.#############
#.#.#...#.#.....................#.#.#...#.#.....#...........#...#.#.........................#.#.#.#.#
#.#.#.###.#.#######.###########.#.#.###.###.#####.#####.#.#.###.###.#.#########.#.#.###.###.#.#.#.#.#
#.#.#.#...#.#.#.#.....#...................#.....#.#.....#.#.#.....#.#...#.#.....#.#.#.#...#.........#
###.#########.#.###.#######.###.###.###.#.#.###########.#####.#.#.###.#.#.###.###.#.#.#######.###.#.#
#.#.#.#.#.#.......#.#.......#.....#.#...#.#.#...........#.....#.#.#...#.#.......#.#.........#.#...#.#
#.#.#.#.#.#######.#######.#####.###.#.#####.###########.#####.###.#.###.#####.#######.###.###.###.###
#.#.........#.#.#.#.......#.....#...#.#.......#...#.........#...#.#.#.....#.#.......#...#...#...#...#
#.#.###.#.#.#.#.#.#####.#######.#.#######.#####.###.###.#.###.###.#.#.#####.#.###.###.#.#.#.#####.###
#.....#.#.#.............#.#...#.#.#.......#...........#.#...#.#...#.#.#.#.#.....#...#.#.#.#.#.....#.#
###.#################.###.###.#.###.#.###.#####.#.#.#.#.###.#.#####.###.#.#.#.#.#############.###.#.#
#.#.#.#.#...#.#.........#.......#.#.#...#.#.#...#.#.#.#...#.#...#.....#...#.#.#.#...#...#.#.....#...#
#.###.#.#.#.#.#####.#####.#.###.#.#########.###.###.###.#.#########.###.#.###.###.###.###.#######.###
#.#.....#.#...#...#.#.....#.#.#...#.......#.#...#.....#.#.......#.....#.#.......#...#...........#...#
#.#####.#####.#.#############.#.#####.###.#.###.###.###.###.#####.#.#.#.#####.###.###.#.#########.#.#
#...................#.#.#.#.........#.#.........#...#...#.....#...#.#.#.#.......#.#.#.#.#.....#...#.#
#####.#.###.#######.#.#.#.#####.###########.#.#####.#####.###.#.#.#######.#.#.#.#.#.###.###.#########
#.....#...#.#...............#.......#...#...#.....#...#...#...#.#.#.#.....#.#.#.....................#
#.#.###.#######.#.###.#####.###.#.#####.#####.#######.#.#####.###.#.###.#####.###.#.#.#.#.#.###.#####
#.#.#.#...#.....#.#.....#.......#.#.............#.....#.....#.#.....#...#.#.....#.#.#.#.#.#...#.....#
#####.#############.#######.#.#.#######.#####.#####.###.#.#####.#######.#.#.###.#.###.#####.###.#.#.#
#.......#.............#.....#.#.#.#.#...#.#.....#.....#.#.#...#...#.....#...#...#.#.....#.#.#...#.#.#
#.###.#####.#####.#####.###.#.#.#.#.#####.###.#######.#####.#################.#.#####.#.#.#####.#####
#.#.....#.#.#.....#...#.#.#.#.#.#.........#.....#.......#.#...#...#...........#.....#.#.......#...#.#
#.###.###.###########.###.#####.#.#.#.###.#.#.###.#.#.#.#.###.###.#####.#.#.#.###.#.#####.#####.#.#.#
#.#.....................#.....#.#.#.#...#...#.#...#.#.#.....#...........#.#.#.#...#.#.#.#.....#.#...#
#####.###.#.###.#.#####.###.#####.#####.#.#######.###.#.#.###.#.#.###.###.###.#.#.###.#.#.#.#.#.###.#
#...#.#...#...#.#.#...............#.#...#.#.......#...#.#...#.#.#.#...#.....#.#.#.......#.#.#.#.#.#.#
#.###.#########.###.#.###.#.#.###.#.###.#.#.###.#.###.###.#.#.#.#####.#.#.#.#.#####.#.#.#####.#.#.###
#.#.#.....#.......#.#...#.#.#.#.#.....#.#.#.#...#...#.#...#.#.#.#.....#.#.#.#.#.....#.#.#...#.#.#.#.#
#.#.#.###.#.#.#####.#.#.#####.#.###.#######.#.#####.###.#.#.#.#######.###.###.#.#.#.#####.#####.#.#.#
#.......#.#.#.#.....#.#.#.....#.......#.#...#.#.....#...#.#.#...#.....#.....#.#.#.#...#.......#...#.#
#####.#.#######.###.#####.#.#.#####.###.###.###.###.#######.#######.#.###.###.#####.#####.#########.#
#.....#.#.......#.....#...#.#...#.#...#.....#...#.#.#.#.....#.......#.#.#...#.#.....#.#.............#
#####.#######.#.###.###.###.#.#.#.#.###.###.###.#.###.#.###.#######.#.#.###.#######.#.###.#####.#####
#...........#.#.#...#.#.#...#.#.#...#.#...#.#...#.#.......#...#.....#...#...#...............#.....#.#
#####.###.#####.#.#.#.#####.#.#####.#.#.#########.###.#.###.#######.###.#####.#.#.#.#.###.#########.#
#.......#.#.#...#.#.#.......#.#.#...#.......#.........#...#.#.....#...#.#...#.#.#.#.#...#...........#
#.#.###.###.###.#.###.#.#.#####.#####.#########.###.#.#####.#.###.#.#.#.#.#####.#.#.#####.#.#.#######
#.#...#.#.......#.#.#.#.#...#.........#...#.....#.#.#.....#.#.#.#...#.#...#.#...#.#.#.#...#.#.......#
#.###.#####.#.###.#.#.###.#.###.#.#.#####.#####.#.#.#######.#.#.#.#.###.###.###.###.#.###.###.#.#####
#.#...#.....#...#.#...#...#.#...#.#.#.....#.#.#.#.......#...#.#...#.#...#...#.....#.....#.#.#.#.....#
#.###.###.#.#.#####.#.#######.###.#.###.#.#.#.#.#####.###########.#####.###.###.#####.#####.#.###.#.#
#.#...#...#.#...#...#...#.....#...#.#...#.........#.....#.#.........#...#.#.#.#.#...........#...#.#.#
#.#.#########.#.#.#.#.#.#.###.###.#.#####.###.###.###.###.#####.###.#####.#.#.#.#.#####.###.###.###.#
#.#.....#.#...#.#.#.#.#.#.#...#.#.#.#.......#...#...#.#.........#...#...........#.#.......#...#.#...#
###.#####.###.#.###.#.#######.#.#.#####.#####.#.#.###.###.###.#.#.#########.###.#####.###.#.#######.#
#...#.....#...#.#...#.#.....#.#...#...#...#...#.#.#.....#...#.#.#.#...#.....#...#.......#.#.....#...#
###.#####.###.#.###########.###.#####.#.#####.#####.#.#######.###.###.#####.#####.###.#####.#########
#...#.........#.#...............#.......#.........#.#.#.......#...#...........#.....#.#.............#
###################################################################################################.t
