s.#######################
#.#.#.#.#.#.#...........#
#.#.#.#.#.#.#####.###.###
#.............#.#.#.#.#.#
###.#######.###.#.#.###.#
#.#...#.....#...........#
#.#######.###.###.#####.#
#.....#.#.......#.#.#.#.#
###.###.#.###.#####.#.###
#.....#.....#...........#
#.#.#####.#####.#.#######
#.#.........#...#.......#
#.#.###.#.#####.#.#.###.#
#.#.#.#.#.....#.#.#...#.#
#.#.#.#.###.#######.###.#
#.#.#.....#.......#...#.#
#####.#.#.#.#.###########
#.#...#.#.#.#.....#...#.#
#.###.#########.#.#.###.#
#...........#...#.......#
#.###.#.#####.###.###.#.#
#.#...#.#.#...#...#...#.#
#.#####.#.#.#.###.#####.#
#...#.....#.#.#.....#...#
#######################.t
