s.#####
#.....#
#####.#
#.....#
#.#.###
#.#...#
#####.t
